#From	 To
AlaAla	ALA
ArgArg	ARG
AsnAsn	ASN
AspAsp	ASP
CysCys	CYS
GlnGln	GLN
GluGlu	GLU
GlyGly	GLY
HisHis	HIS
IleIle	ILE
LeuLeu	LEU
LysLys	LYS
MetMet	MET
PhePhe	PHE
ProPro	PRO
SerSer	SER
ThrThr	THR
TrpTrp	TRP
TyrTyr	TYR
ValVal	VAL
fMetMet	FMET